#################
##########......#
#......###......#
#......###......#
#......###......#
#......###......#
#......###......#
##########......#
#################
##.......########
##.......##.....#
##.......##.....#
##.......##.....#
##.......##.....#
##.......########
#################